Ms, Ms, Ms, Ha, Hhd, Hhd^Fp, Md, Gll^Fp, Ms, Ms, Ms, Ms, Md, Md, Hhd, Ha, Ha, Ha, Gll^Fp, Gll^Fp, Md, Md, Ms, Ms, Ms, Ms, Ms, Md, Md, Md, Hhd, Re, Hhd, Md, Md, Md, Ms, Md, Ms, Ms, Ms, Ms, Ms, Md, Md
Md, Ms, Md, Hhd, Hhd, Hhd, Md, Md, Md, Ms, Md, Ms, Md, Md, Md, Hhd, Hhd, Md, Md, Gll^Fp, Gll^Fp, Md, Md, Ms, Md, Ms, Hhd^Vhh, Md, Md, Md, Md, Re, Re, Md, Md, Md, Md, Ms, Ms, Ms, Md, Ms, Md, Md, Md
Md, Md, Md, Md, Hhd, Hhd, Hhd, Md, Md, Md, Md, Md, Md, Md, Md, Hhd, Hhd, Hhd, Hhd, Gll^Fp, Gll^Fp, Hhd, Md, Md, Md, Md, Md, Md, Md, Md, Hhd, Hhd, Re, Hhd, Hhd^Es, Md, Md, Md, Md, Md, Hhd, Ha, Md, Md, Hhd
Md, Md, Md, Md, Hhd, Hhd^Es, Hhd, Hhd, Md, Md, Hhd^Fp, Md, Md, Md, Hhd, Hhd, Hhd, Hhd, Hhd, Gll^Fp, Gll^Fp, Hhd, Hhd^Fp, Md, Hhd, Md, Hhd, Md, Hhd, Md, Md, Md, Re, Re, Md, Md, Hhd^Es, Hhd^Vu, Md, Hhd^Es, Hhd, Hhd, Hhd, Hhd, Hhd
Md, Md, Hhd, Hhd, Hhd, Hhd, Hhd, Hhd, Gll^Fp, Gll^Fp, Gll^Fp, Hhd^Fp, Hhd^Fp, Hhd, Hhd, Hhd^Vhh, Hhd, Hhd, Gd, Hhd, Gll^Fp, Gll^Fp, Gll^Fp, Gd, Gd, Hhd, Gd, Hhd, Hhd, Md, Ms, Md, Re, Hhd, Md, Md, Hhd^Es, Hhd^Es, Hhd^Dr, Hhd, Gd, Hhd, Gs, Gs, Gs
Hhd, Hhd, Gd, Ce, Hhd, Ce, Gll^Fp, Gs^Es, Gll^Fp, Gs, Gll^Fp, Gll^Fp, Gs, Hhd, Hhd, Hhd, Gs, Gd, Gd, Gd, Gll^Fp, Gll^Fp, Gll^Fp, Gd, Gd, Gd, Gd, Hhd, Hhd, Md, Hhd, Re, Re, Hhd, Gs, Hhd, Gd, Hhd^Dr, Hhd, Hhd, Gd, Gs, Hhd, Gs, Gs
Hhd, Hhd, Gd, Ce, Ce, Ce, Gll^Fp, Gll^Fp, Gd, Gll^Fp, Hhd^Fp, Gll^Fp, Hhd, Gll^Fp, Gll^Fp, Gs, Gd, Gd, Gll^Fp, Gll^Fp, Gll^Fp, Gll^Fp, Gll^Fp, Gll^Fp, Gll^Fp, Gd, Gd, Hhd, Gd, Hhd, Hhd, Re, Re, Hhd, Hhd, Gd, Gd, Hhd, Gd, Gd, Hhd, Hhd, Hhd, Gd, Gd
Gll^Fp, Hhd, Gd, Gd, Gll^Fp, 6 Ke, Gll^Fp, Gs, Hhd^Fp, Hhd, Hhd, Hhd^Fp, Hhd, Hhd, Hhd^Fp, Hhd^Fp, Gll^Fp, Gll^Fp, Gd, Gll^Fp, Gs, Hhd^Fp, Hhd, Gll^Fp, Re, Gll^Fp, Gs^Vh, Gd, Gd, Gd, Re, Re, Hhd, Hhd, Hhd, Gd, Gd, Gd, Hhd, Hhd^Fp, Gd, Hhd, Gs, Gd, Gs
Gll^Fp, Gll^Fp, Gll^Fp, Gll^Fp, Gll^Fp, Gll^Fp, Gd, Gll^Fp, Hhd^Fp, Hhd, Gd, Hhd^Fp, Gd, Gd^Es, Gs^Dr, Gd, Gll^Fp, Gd, Gd, Gs, Gs, Hhd^Fp, Hhd, Gd, Gd, Gd, Gs, Gd, Gd, Gd, Re, Re, Gd, Gd, Gd, Gd, Gd, Hhd, Gd, Gd, Gs, Gs, Gs^Eff, Gs^Eff, Gs^Eff
Gll^Fp, Gll^Fp, Gll^Fp, Gll^Fp, Gd, Gd, Gd^Vh, Gll^Fp, Hhd, Hhd, Hhd, Gd, Gd^Es, Gd, Gd^Es, Gd, Gd, Gll^Fp, Gll^Fp, Gs, Gs, Hhd, Hhd, Gd, Gd, Gd, Gs, Gd, Gs, Re, Re, Re, Gs, Gs, Gs, Gs, Gs, Gs, Gs, Gs, Gs, Gs^Eff, Gs^Eff, Gd^Vl, Rb^Gvs
Gs, Gs, Gll^Fp, Gll^Fp, Gs, Gd, Gd, Hhd, Md, Md, Md, Hhd, Gd, Gd^Es, Gd, Gll^Fp, Gs, Gll^Fp, Gll^Fp, Gs, Gd, Gd, Gs, Gd, Gs, Gs, Gd, Gs, Gs^Es, Re, Re, Gd, Hhd, Gd, Gs^Fp, Hhd^Fp, Qxe, Gs, Gs, Gs, Gs, Gs, Gs^Es, Gs^Eff, Gs^Eff
Gs^Es, Gd, Gll^Fp, Gll^Fp, Gs, Gs, Hhd, Hhd, Md, Md, Hhd, Hhd, Gd, Gd, Gd, Gs^Vht, Hhd, Gs, Hhd, Hhd, Hhd, Gd, Gs, Gs, Gd, Gd, Gd, Gd, Gd, Re, Re, Hhd, Md, Hhd, Hhd, Gs^Fp, Gs^Vht, Qxe, Gd, Gd, Gd, Gs, Gd, Gs, Gs
Gs^Es, Gd, Gd, Gll^Fp, Gs, Gs, Gs, Hhd, Hhd, Hhd, Hhd, Gd, Gd, Gll^Fp, Gd, Gd, Gd, Gs, Hhd^Fp, Hhd, Hhd^Fp, Hhd^Fp, Gd, Hhd, Hhd, Gd, Hhd, Gd, Gd, Re, Re, Hhd, Hhd, Md, Hhd^Fp, Gd, Gd, Gd, Gd, Gd, Gd, Gd, Gd, Gs, Gs
Gs, Gd, Gs, Gs^Fp, Gs, Gs, Gs, Hhd, Gs, Gd, Gd, Gd, Qxe, Qxe, Gll^Fp, Gd, Gll^Fp, Gll^Fp, Gs^Efm, Hhd^Fp, Gs, Hhd, Hhd^Fp, Hhd, Md, Hhd^Fp, Hhd, Hhd, Hhd, Re, Re, Gd, Gd, Hhd, Gd, Gd, Gd, Gll^Fp, Gs^Fms, Gll^Fp, Gll^Fp, Gd, Gs, Gd, Gs
Gs, Gs^Vc, Gd, Gs, Gll^Fp, Gs, Gd, Gd, Hhd, Gd, Gd, Qxe, Gs, Gd, Gs^Fds, Gll^Fp, Gll^Fp, Gll^Fp, Gll^Fp, Gll^Fp, Gs, Gd, Gd, Hhd, Hhd, Hhd^Fp, Gs, Gd, Gd, Re, Re, Re, Gd, Gd, Gs, Gd, Gs, Gll^Fp, Gll^Fp, Gll^Fp, Gs, Gs, Gs, Gd, Gs
Gs, Gd, Gd, Gd, Gd, Gd, Gd, Hhd^Fp, Gs, Gd, Gs, Qxe, Gd, Gd, Gd, Gs^Fms, Gs, Gll^Fp, Gll^Fp, Gll^Fp, Gs^Fms, Gd, Gs, Hhd, Gs, Gs, Gd, Gd, Gd, Gd, Re, Re, Gd, Gd, Gd, Gd, Gd, Gs, Gd, Gll^Fp, Gll^Fp, Gs, Gs, Gs, Gs
Gs, Gd, Gd, Gd, Gll^Fp, Gll^Fp, Gll^Fp, Gll^Fp, Gll^Fp, Gs, Gs, Qxe, Gd, Gd, Gll^Fp, Gs, Gll^Fp, Gll^Fp, Gll^Fp, Gs^Es, Gs, Gd, Gd^Vh, Gs, Rb^Gvs, Gs, Gd, Gd, Gd, Gd, Re, Re, Gd, Gd, Gd, Gd, Gd, Gd, Gd, Gd, Gs, Gll^Fp, Gll^Fp, Gs, Gs
Gd, Gd, Gll^Fp, Gll^Fp, Gll^Fp, Gll^Fp, Gs^Fms, Gs^Fds, Gs^Fms, Gll^Fp, Gll^Fp, Gll^Fp, Gll^Fp, Gd, Gll^Fp, Gll^Fp, Gg, Gg, Gs, Gll^Fp, Gll^Fp, Gd, Gd, Rb^Gvs, Rb^Gvs, Rb^Gvs, Gd, Gd, Gd, Gd, Re, Re, Gs, Gd, Gd, Gd, Gd, Gd, Gd, Gd, Gs, Gs^Fp, Gd^Vl, Gs, Gs
Gd, Gd, Gd, Gll^Fp, Gll^Fp, Gll^Fp, Gll^Fp, Gs^Fms, Gs^Fds, Gs^Fds, Gs^Fds, Gll^Fp, Gll^Fp, Gll^Fp, Gll^Fp, Gll^Fp, Gll^Fp, Gg, Gs, Gs, Gll^Fp, Gd, Gd, Gd, Gd, Gd, Gd, Gd, Gd, Gd, Re, Re, Gs, Gd, Gd, Gd, 5 Ke, Gd, Gs, Gd, Gs, Gs, Gs, Gs, Gll^Fp
Gd, Gd, Gll^Fp, Gll^Fp, Gll^Fp, Gll^Fp, Gd^Eff, Gll^Fp, Gs, Gs, Gs, Gs^Es, Gd, Gll^Fp, Gd, Gll^Fp, Gll^Fp, Gll^Fp, Gll^Fp, Gd, Gs, Gd, Gd, Gd, Gd, Gd, Gd, Gd, Gd, Gd, Re, Re, Gd, Gd, Gd, Gd, Gd, Ce, Ce, Gll^Fp, Gll^Fp, Gs, Gll^Fp, Gll^Fp, Gs^Fms
Gd, Gd, Gd, Gd, Gd^Eff, Gd^Eff, Gd^Vh, Gd^Eff, Gd^Eff, Gd, Gd, Gd, Gd, Gd, Gs, Gs^Em, Gs, Gll^Fp, Gs, Gll^Fp, Gll^Fp, Gs, Gd, Gd, Gs, Gs, Gs, Gs, Gs, Gs, Re, Re, Gs, Gd, Gd, Gs, Gs, Gs, Gs, Ce, Ce, Gll^Fp, Gll^Fp, Gll^Fp, Gs^Fms
Hh, Gd, Gd^Eff, Gd^Eff, Rb^Gvs, Rb^Gvs, Rb^Gvs, Rb^Gvs, Rb^Gvs, Gd^Eff, Gd^Eff, Gll^Fp, Gll^Fp, Gs, Gd, Gd, Gd, Gs, Gd, Gd, Gd, Gs^Fms, Gd, Gs, Gs^Vht, Gs, Gs, Gs, Gd, Gd, Re, Re, Gd, Gd, Gd, Gs, Gs, Gs, Gs, Ce, Gg, Gll^Fp, Gll^Fp, Gll^Fp, Gs^Fms
Mm, Gs, Gs, Gd^Eff, Gd^Eff, Rb^Gvs, Rb^Gvs, Rb^Gvs, Gd^Eff, Gd^Eff, Gg, Gg, Gg, Gd^Fp, Gs, Gd, Gd, Gd, Gd, Gd, Gd, Gd, Gd, Gs, Gs, Gg, Gs, Gs, Gd, Gd, Re, Re, Gd, Gd, Gd, Gd, Gd, Gd, Gd, Gll^Fp, Gs, Gg, Gll^Fp, Gs^Fds, Gs^Fds
Mm, Hh, Hh, Gs, Gs, Gd^Eff, Gd, Gd^Eff, Gs, Gg, Gg, Gg, Gg, Gs, Gd, Gd, Gd, Gd, Gd, Gd, Gs, Gd, Gd, Gd, Gd, Gs, Gd, Gd, Gd^Fp, Gd, Re, Re, Gd, Gd, Gd, Gd, Gll^Fp, Gd, Gll^Fp, Gll^Fp, Gg, Gs^Efm, Gll^Fp, Gll^Fp, Gll^Fp
Mm, Mm, Hh, Gs, Gg, Gd, Gd, Gs, Gd, Gg, Gs, Gg, Gg, Gd, Gs, Gd, Gs, Gs, Gd, Gd, Gd, Gd, Gd, Gd, Gd, Gd, Gd, Gd^Fp, Gd, Gd^Fp, Re, Re, Gd, Gd, Gd, Gd, Gll^Fp, Gd, Gll, Gs, Gll^Fp, Gll^Fp, Gll^Fp, Gll^Fp, Ww
Hh, Mm, Hh, Gg, Gs, Gd, Gs, Gd, Gd, Gd, Gs, Gd, Gd, Gd, Gs, Gs, Gd^Vl, Gd, Gs, Gd, Gs, Gs, Gll^Fp, Gs, Gll^Fp, Gd, Gs, Gd, Gd, Re, Re, Re, Gd^Fp, Gd^Fp, Gd, Gll, Gs^Fms, Gll^Fp, Gll^Fp, Gll^Fp, Gll^Fp, Gll^Fp, Gs^Fms, Ww, Gll^Fp
Gs^Vc, Hh, Hh, Gs, Gs, Gs, Gs, Gs, Gs, Gs, Gs, Gs, Gs, Gs, Gs^Es, Gs, Gs, Gs, Gs^Em, Gs, Gs, Gg, Gll^Fp, Gll^Fp, Gll^Fp, Gll^Fp, Gll, Gd, Re, Re, Re, Gd, Gd^Vl, Gd, Gs^Fms, Gd, Gll^Fp, Gll^Fp, Gll^Fp, Gll^Fp, Gll^Fp, Gll^Fp, Gll^Fp, Gll^Fp, Gll^Fp
Gs, Gs, Gs, Gs, Gs, Gs, Gs, Gs^Vc, Gs, Gg, Gg, Gg, Gs, Gs, Gs, Gs, Gs, Gs, Gs, Gs, Gg, Gll^Fp, Gs^Efm, Gs^Fms, Gll, Gll^Fp, Gll^Fp, Gd, Re, Re, Gd, Gd, Gs^Fms, Gs^Fms, Gs, Gs, Gll^Fp, Gs^Fms, Gll^Fp, Gll^Fp, Gll^Fp, Gll^Fp, Gll^Fp, Gll^Fp, Gll^Fp
Gs, Gs, Gs, Gs, Gll^Fp, Gs, Gll^Fp, Gs, Gs, Gs, Gs, Gs, Gs, Gs, Gs, Gs, Gs, Gs, Gs, Gs, Gs, Gll^Fp, Gs, Gs, Gd, Gd, Re, Re, Re, Re, Gd, Gs, Gg, Gg, Gg, Gs^Em, Gll, Gll^Fp, Gll^Fp, Gs^Fp, Gs^Em, Gll^Fp, Gll^Fp, Gs^Fms, Gll^Fp
Gg, Gs, Gs^Fms, Gll^Fp, Gs^Fds, Gs^Fms, Gll^Fp, Gs, Gs, Gg, Gg, Gg, Gg, Gs, Gs, Gs, Gg, Gs, Gs, Gs, Gs^Vc, Gs, Gs, Gs, Gd, Re, Re, Re, Gd, Gd, Gs, Gg, Gg, Gg, Gg, Gg, Gs, Gs^Em, Gs, Gs, Gg, Gs^Em, Gg, Gg, Gg
Gs, Gll^Fp, Gs^Fms, Gs^Fms, Gs^Fds, Gs^Fds, Gd, Re, Gs, Gs, Gs, Gg, Gs, Gs^Es, Gg, Gg, Gg, Gs, Gg, Gs, Gg, Gs, Gs, Gs, Rd, Re, Rd, Rd, Gs^Vc, Gs, Gg, Gg, Gg, Gg, Gg, Gg, Gg, Gg, Gg^Em, Gg, Gg, Gg, Ds, Gg^Es, Gg
Gg, Gs, Gs, Gs^Fms, Gs, Gs^Em, Gg, Gg, Gs, Gs, Gs, Gg, Gg, Gg, Gg, Gg, Gg, Gg, Gs, Gg, Gg, Gg, Ce, Gs, 1 Ke, Rd, 2 Ke, Gs, Ce, Gs, Gg, Gg, Gg, Gg, Gg, Gg, Ds, Gg, Gg, Gg, Ds, Ds, Ds^Vht, Ds, Gg^Es
Gg, Gs, Gg, Gs, Gs, Gs, Ds, Gg, Gg, Gs^Es, Gg, Gg, Ds, Gg, Gg, Gs, Ds, Ds, Ds, Ds, Ds, Ds, Ds, Ce, Ce, Ce, Ce, Ce, Ds, Gg, Ds, Ds, Ds, Ds, Ds, Ds, Ds, Ds, Ds, Ds, Ds, Ds, Ds, Ds, Ds
Ds, Gg, Ds, Ds, Ds, Ds, Ds, Ds, Ds, Ds, Ds, Ds, Ds, Ds, Ds, Ds, Ww, Ww, Ww, Ww, Ww, Ds, Ds^Es, Ds, Ds, Ce, Ds, Ds, Ds, Ds, Ww, Ww, Ww, Ww, Ww, Ww, Ww, Ww^Es, Ww^Es, Ww, Wo, Ww, Ww^Es, Ds, Ds
Ww, Ds, Ww, Ww, Ww, Ds, Ww, Ww, Ww, Ww, Ww, Ww, Ww, Ww, Ww, Ww, Wo, Ww, Wo, Wo, Wo, Ww, Ww, Ww, Ww, Ww, Ww, Ww, Ww, Ww, Wo, Ww, Wo, Ww, Wo, Wo, Wo, Wo, Wo, Wo, Wo, Wo, Wo, Ww, Ww
Wo, Ww, Wo, Wo, Wo, Ww, Wo, Wo, Wo, Wo, Wo, Ww, Wo, Wo, Wo, Ww^Vm, Wo, Wo, Wo, Wo, Wo, Ww, Ww, Ww, Ww, Ww, Ww, Ww, Wo, Wo, Wo, Wo, Wo, Wo, Wo, Wo, Wo, Wo, Wo, Ww^Vm, Wo, Wo, Wo, Wo, Wo
Wo, Wo, Wo, Wo, Wo, Wo, Wo, Wo, Wo, Wo, Wo, Wo, Wo, Wo, Wo, Wo, Wo, Wo, Wo, Wo, Wo, Wo, Ww, Ww, Ww, Ww, Ww, Ww, Wo, Wo, Wo, Wo, Wo, Wo, Wo, Wo, Ww, Wo, Wo, Wo, Wo, Wo, Wo, Wo, Wo
