Ha, Ms, Ha, Ms, Ha^Fpa, Ha^Fpa, Aa^Fpa, Aa^Fpa, Hh, Gll^Fdw, Hh, Hh^Fp, Hh^Fp, Hhd, Hhd, Hhd, Hhd, Hhd, Hhd, Hhd, Hhd^Fp, Rb, Gd, Gd, Gd, Gd, Gs, Wwt, Gs, Rb, Gd
Ms, Ha, Ha, Ha, Ha, Ha^Fpa, Ha^Fpa, Ha^Vca, Hh^Fpa, Hh, Hh, Hh, Hh^Fp, Hh^Fp, Hh^Fp, Hhd, Hhd^Fp, Hhd^Fp, Hhd, Hhd, Hhd, Hhd, Hhd, Gd, Gs^Fp, Gs, Wwt, Wwt, Gs, Gd, Gd
Ms, Ms, Ms, Ha, Ha, Ha, Ha, Ha^Fpa, Aa^Fpa, Hh^Fpa, Hh^Fpa, Hh^Fpa, Gs^Fpa, Gs^Fp, Gs^Fpa, Hhd^Fp, Hh, Hhd^Fp, Hhd, Hhd, Hhd, Hhd^Fp, Hh^Fp, Hhd, Wwt, Wwt, Hh, Gs^Fp, Gd, Gd, Gd
Ms, Ms, Ms, Ms, Ms, Ha, Ha, Ha, Ha, Aa^Fpa, Ha^Fpa, Hh^Fpa, Aa^Fpa, Aa^Fpa, Ha^Fpa, Hh^Fpa, Hh^Fpa, Hh^Fpa, Aa^Fpa, Hh^Fpa, Hh, Hhd, Hh, Wwt, Hh, Hh, Hh, Hhd^Fp, Hhd, Gd^Fp, Re
Ms, Ms, Ms, Ms, Ms, Ms, Ms, Ms, Ms, Ha, Ha, Ha, Ha, Aa^Fpa, Hh, Ha^Fpa, Hh, Aa^Fpa, Hh^Fpa, Hh^Vhha, Hh^Fpa, Hhd^Fp, Rb, Wwt, Hh^Fp, Hhd^Fp, Hhd^Fp, Hhd, Hhd, Hhd, Hhd
Ms, Ms, Ms, Ms, Ms, Ms, Ms, Ms, Ms, Ms, Ms, Ha, Ha, Hh^Fpa, Hh^Fpa, Hh, Hh, Hh^Fpa, Hh^Fpa, Hh^Fpa, Hh^Fpa, Cha, Cha, Wwt, Hhd^Fpa, Hhd^Fp, Hh^Fpa, Hh^Fp, Gll^Fp, Gll^Fp, Hhd
Ms, Ms, Ms, Ms, Ms, Ms^Vaa, Ms, Ms, Ms, Ms, Ms, Ms, Ms^Voa, Hh^Fpa, Hh^Fpa, Hh^Fpa, Hh, Hh, Hh^Fpa, Hh^Fpa, Rb, 6 Kha, Wwt^Bsb\, Wwt, Wwt, Ha^Fpa, Ha^Fpa, Hh^Fpa, Hh^Fpa, Gll^Fp, Hh
Ms, Ms, Ms, Ms, Ms, Ms, Ms, Ms, Ms, Ms, Ms, Ms, Ms, Ms, Ha, Ha, Ha^Fpa, Hh, Hh, Hh, Hhd^Fpa, Wwt, Rb, Kha, Hhd, Ai, Ai, Ha^Vla, Ha^Fpa, Ha^Fpa, Hh^Fpa
Ms, Ms, Ms, Ms, Ms, Ms, Ms, Ms, Ms, Ms, Ms, Ms, Ms, Ms, Ms, Ha, Hh^Fpa, Hh, Hh^Fpa, Hh^Fpa, Hhd^Fpa, Wwt, Gd^Fp, Hh, Hh^Fpa, Hhd, Wwt, Ha, Ha, Ha^Fpa, Ha^Fpa
Ms, Ms, Ms, Ms, Ha, Ms, Ms, Ms, Ai, Ms, Ai, Ms, Ai, Ms, Ms, Ha, Hh^Fpa, Hh, Hhd, Hhd^Fpa, Ai, Wwt, Gd^Fp, Hh^Fpa, Ha, Ha, Ai, Ha, Ha, Ha, Ha^Fpa
Ms, Ms, 5 Kha, Ha, Ms, Ms, Ai, Ai, Ms, Ai, Ms, Ai, Ai, Ai, Ai, Hh^Fpa, Hh^Fpa, Ha, Wwt, Ai, Hhd^Fpa, Hhd^Fpa, Hh^Fpa, Hh^Fpa, Ha, Ha, Ha, Ai, Ai, Ha, Ha
Ms, Ms, Cha, Cha, Ai, Ai, Ms, Ms, Ms, Ms, Ms, Ms, Ms, Ms, Ms, Ai, Ai, Ai, Ha^Fpa, Hhd^Fpa, Re, Hhd^Fpa, Hh^Fpa, Hh, Ha, Ms, Ms, Ms, Ai, Ms, Ms
Ms, Ms, Ai, Ai, Ms, Ms, Ms, Ms, Ms, Ms, Ms, Ms, Ms, Ms, Ms, Ms, Ms, Ha, Hhd, Re, Hhd, Hh^Fpa, Ha, Ha, Ms, Ms, Ms, Ms, Ai, Ai, Ms
Ms, Ms, Ai, Ms, Ms, Ms, Ms, Ms, Ms^Xm, Ms, Ms^Xm, Ms, Ms^Xm, Ms, Ms, Ms, Ms, Ha^Fpa, Hhd, Re, Ha^Fpa, Ms, Ms, Ms, Ms, Ms, Ms, Ms, Ms, Ai, Ms
Ms, Ms, Ai, Ms, Ms, Ms, Ms, Ms^Xm, Ms^Xm, Ms^Xm, Ms^Xm, Ms^Xm, Ms^Xm, Ms, Ms, Ms^Voa, Ms, Ha, Hhd, Re, Ha, Ms, Ms, Ms, Ha^Vla, Ms^Xm, Ms^Xm, Ms, Ms, Ms, Ms
Ai, Ai, Ms, Ms, Ms, Ms, Ms^Xm, Ms^Xm, Ms^Xm, Ms^Xm, Ms^Xm, Ms, Ms^Xm, Ms, Ms, Ms, Ha, Ha, Hhd, Hhd, Ms, Ms, Ms, Ms, Ms, Ms^Xm, Ms, Ms, Ms, Ms, Ms
Ms, Ms, Ms, Ms, Ms, Ms, Ms^Vaa, Ms^Xm, Ms^Xm, Ms^Xm, Ms^Xm, Ms^Xm, Ms, Ms, Ms, Ms, Ha, Re, Hhd, Hhd, Ms, Ms, Ms, Ms, Ms^Xm, Ms, Ms, Ms, Ms, Ms, Ms
Ms, Ms, Ms, Ms, Ms, Ms, Ms, Ms, Ms, Ms, Ms, Ms, Ms, Ms, Ms, Ms, Ha, Re, Hhd, Ms, Ms, Ms, Ms, Ms, Ms^Xm, Ms^Xm, Ms^Xm, Ms, Ms, Ms, Ms
Ms, Ms, Ms, Ms, Ms, Ms, Ms^Xm, Ms^Xm, Ms^Xm, Ms, Ms, Ms, Ms, Ms, Ms, Ha, Re, Re, Ha, Ms, Ms, Ms, Ms, Ms^Xm, Ms^Xm, Ms^Xm, Ms^Xm, Ms^Xm, Ms^Xm, Ms, Ms
Ms, Ms, Ms, Ms, Ms, Ms, Ms, Ms^Xm, Ms, Ms, Ms, Ms, Ms, Ms, Ms, Ha, Re, Hhd, Ms, Ms, Ms, Ms, Ms, Ms, Ms^Xm, Ms^Xm, Ms^Xm, Ms^Xm, Ms, Ms, Ms
Ms, Ms, Ms, Ms, Ms, Ms^Voa, Ms, Ms, Ms, Ms, Ms, Ms, Ms, Ms, Ha, Hhd, Hhd, Ha, Ms, Ms, Ms, Ms, Ms, Ms^Xm, Ms, Ms^Xm, Ms, Ms^Xm, Aa^Vaa, Ms, Ms
Ms, Ms, Ms, Ms, Ms, Ms, Ms, Ms, Ms, Ms, Ms, Ms, Ha, Ha, Hhd, Hhd, Ha, Ms, Ms, Ms, Ms, Ms, Ms, Ms, Ms, Ms, Ms, Ms, Ms, Ms, Ms
Ms, Ms, Ms, Ms, Ms, Ms, Ms, Ms, Ms, Ms, Ms, Ms, Hhd, Hhd, Re, Re, Ha, Ms, Ms, Ms, Ms, Ms, Ms, Ms, Ms, Ms, Ms, Ms, Ms, Ms, Ms
Ms, Ms, Ms, Ms, Ms, Ms, Ms, Ms, Ms, Ms, Ha, Ha, Hhd, Re, Hhd, Hhd, Ha, Ha, Ms, Ms^Voa, Ai, Ms, Ms, Ms, Ms, Ms, Ms, Ms^Voa, Ms, Ms, Ms
Ms, Ms, Ms, Ms, Ms, Ms, Ms, Ms, Ms, Ms, Ha, Hhd, Re, Re, Hhd, Ha, Ha, Ms, Ai, Ai, Ai, Ai, Ai, Ms, Ms, Ms, Ms, Ms, Ms, Ms, Ms
Ms, Ms^Vaa, Ms, Ms, Ms, Ms, Ms, Ms, Ms, Ms, Hhd, Hhd, Re, Hhd, Ms, Ms, Ms, Ms, Ai, Ai, Ai, Ai, Ms, Ms, Ms, Ms, Ms, Ms, Ms, Ms, Ms
Ms, Ms, Ms, Ms, Ms, Ms, Ms, Ms, Ms, Ms, Cea, Cea, Cea, Hhd, Ha^Vhha, Ms, Ms, Ai, Ai, Ai, Ai, Ms, Ms, Ms, Ms, Ms, Ms, Ms, Ms, Ms, Ms
Ms, Ms, Ms, Ms, Ms, Ms, Ms, Ms, Ha, Ha, Cea, 2 Kea, Cea, Hhd, Ha, Ms, Ms, Ms, Ms, Ms, Ms, Ms, Ms, Ms, Ms, Ms, Ms, Ms, Ms, Ms, Ms
Ms, Ms, Ha^Fpa, Ha^Fpa, Ms, Ms, Ms, Ms, Ha^Vhha, Hhd, Cea, 1 Kea, Cea, Hhd^Fpa, Ha^Fpa, Ms, Ms, Ms, Ha^Fpa, Ms, Ms, Ms, Ms, Ms, Ms, Ms, Ms, Ms, Ms, Ms, Ms
Ha, Ha, Ha, Ha, Ha, Ha, Ha^Fpa, Hh^Fpa, Hh^Fpa, Hhd, Hhd, Cea, Hhd, Hhd, Hh^Fpa, Ms^Fpa, Hh^Fpa, Ms, Hh^Fpa, Ha^Fpa, Ha^Fpa, Ha^Fpa, Ha^Fpa, Ms, Ha^Fpa, Ha^Vla, Ha^Fpa, Ms, Ms, Ms, Ms
Hhd, Ha, Hhd, Ha, Hhd, Hh^Fpa, Ms, Hh^Fpa, Hhd, Hh^Fpa, Rb, Rb, Hhd, Hhd^Fpa, Hhd, Hh^Fpa, Hhd, Hhd^Fpa, Hhd, Hhd^Fpa, Hhd, Ha^Fpa, Hhd, Ha^Fpa, Hhd, Ha^Fpa, Hhd, Ha, Ha, Ha, Ha
