Gs^Fp, Gs^Fp, Gs^Fp, Gs^Fp, Hh^Fp, Md, Md, Md, Hd, Hd, Hhd^Fp, Gd^Fp, Gs^Fp, Wwt, Ai, Wwt, Wwt, Wwt, Ai, Hh^Fp, Gs^Fp, Hh^Fp, Gs^Fp, Gs^Fp, Gs^Em, Gs^Fp, Md, Md, Md, Md, Md, Md
Hh^Fp, Gs^Fp, Gs^Fp, Gs^Fp, Gs^Fp, Md, Md, Md, Md, Md, Gs^Fp, Gs^Fp, Gs^Fp, Hh^Fp, Gs^Fp, Ai, Ds, Ai, Gs^Fp, Gs^Fp, Gs^Fp, Gs^Fp, Gs^Fp, Gs^Fp, Gs^Fp, Gs^Fp, Gs^Fp, Gs^Fp, Hh^Fp, Md, Md, Hhd
Hh^Fp, Gs^Fp, Hh^Fp, Gs^Fp, Gs^Fp, Hh^Fp, Gs^Fp, Hh^Fp, Gs^Fp, Gs^Fp, Gd^Fp, Gs^Fp, Hh^Fp, Gs^Fp, Gs^Fp, Gs^Fp, Gs^Fp, Gs^Fp, Gs^Fp, Gs^Fp, Hh^Fp, Hh^Fp, Gs^Fp, Hh^Fp, Gs^Fp, Gs^Fp, Gs^Fp, Gs^Fp, Gs^Vl, Gs^Fp, Gs^Fp, Gd^Fp
Gs^Fp, Gs^Fp, Gs^Fp, Gs^Fp, Gs^Fp, Gs^Fp, Gs^Fp, Gs^Fp, Gd^Fp, Gd^Fp, Hh^Fmf, Gd^Fp, Gs^Fp, Hh^Fp, Gs^Fp, Gs^Fp, Gs^Fp, Gs^Vl, Gs^Fp, Gs^Fp, Gs^Fp, Gs^Fp, Gs^Fp, Gs^Fp, Hh^Fp, Gs^Fp, Hh^Fp, Gs^Fp, Hh^Fp, Gs^Fp, Gs^Fp, Gs^Fp
Hh^Fp, Gs^Fp, Gs^Fp, Gs^Fp, Gs^Fp, Gs^Fp, Gg^Ve, Gd^Fp, Hh^Fms, Hh^Fmf, Hh^Fms, Hh^Fmf, Hh^Fms, Gd^Fp, Gs^Fp, Hh^Fp, Gs^Fp, Hh^Fp, Hh^Fp, Gs^Fp, Gs^Fp, Gs^Fp, Gs^Fp, Gs^Fp, Hh^Fp, Hhd, Hhd, Hh^Fp, Hh^Fp, Hh^Fp, Hh^Fp, Hh^Fp
Gs^Fp, Gs^Fp, Gs^Fp, Gs^Fp, Gs^Fp, Ai, Ai, Ai, Wwt, Ai, Wwt, Ai, Ai, Ai, Ai^Es, Mm, Mm, Hh, Hh, Hh, Ch, Ch, Ch, Gs^Fp, Hhd, Hhd, Hhd, Hhd, Hhd, Hhd, Hhd, Hhd
Gs, Gg, Gg, Gg, Gd, Hh^Fms, Gs, Ai, Wwt, Wot, Wot, Wwt, Wot, Wwt, Wwt, Ai, Ai, Ai, Wwt, Ai, Ch, 5 Kh, Ch, Mm, Mm, Mm, Mm, Mm, Mm, Mm, Mm, Mm
Hh, Gd, Gd, Gs^Fp, Gs^Fp, Hh^Fms, Ai, Ai, Wwt, Wot, Wot, Wot, Wot, Wot, Wot, Wwt, Wot, Wwt, Wwt, Ai, Ch, Ch, Ch, Hh^Fms, Hh^Fms, Hh^Fms, Hh^Fms, Hhd, Gg^Ve, Mm, Mm, Mm
Hhd^Fdw, Hhd^Fp, Hhd^Fp, Hhd^Fdw, Gs^Fp, Gd^Fp, Hh^Fmf, Hh^Fms, Ai, Wwt, Ai^Es, Wwt, Wwt, Wot, Wot, Wot, Wot, Wot, Wwt, Ai, Hh^Fms, Hh, Re, Gs, Gd, Hh^Fp, Hh^Fp, Hh^Fp, Hh^Fp, Hh^Fp, Hh^Fp, Hh^Fp
Hhd^Fdw, Hhd^Fdw, Hhd^Fp, Gs^Fp, Gs^Fp, Gd^Fp, Gd^Fp, Hh^Fms, Hh^Fmf, Hh^Fms, Gs^Fp, Ai, Ai, Wwt, Wwt, Wwt, Wwt, Wwt, Wwt, Ai, Hh^Fdf, Hh^Fp, Re, Re, Gd, Hhd, Hhd, Hh^Fms, Hh^Fms, Hhd, Hh^Fms, Hhd
Gs^Fp, Hhd^Fp, Gs^Fp, Gs^Fp, Hh^Fp, Gs^Fp, Gs^Fp, Gd^Fp, Gd^Fp, Gd^Fp, Gs^Fp, Re, Re, Hh^Fms, Ai, Wwt, Ai, Ai, Ai^Es, Ai, Hh^Fms, Hh^Fms, Re, Re, Gs^Fp, Hh^Fp, Gs^Fp, Hhd, Hhd, Hh^Fp, Hh^Fms, Hhd
Md, Md, Md, Md, Gd^Ve, Gg, Gg, Gg, Gg, Re, Re, Re, Re, Re, Re, Re, Re, Re, Re, Re, Re, Re, Re, Wwt, Ai, Md, Md, Md, Ms, Md, Md, Md
Hhd, Hhd, Hhd, Hhd, Gd, Gs, Gg, Gg, Re, Re, Gg^Vh, Gg, Gg, Gg, Gg, Gg, Gg, Gg, Gg, Gg, Gg, Gg^Vh, Gg, Wwt, Wwt, Ai, Ai, Md, Ms, Ms, Ms, Md
Hh, Gd, Gs, Gd, Gs, Gg, Re, Re, Hh, Hh, Hh, Hh, Hh, Gs, Hh, Gg, Gs, Gg, Hh, Hh, Hh, Gg, Hh, Gg, Gs, Gg, Gd, Hd, Md, Md, Md, Md
Gs, Gs, Hh, Hh, Hh, Re, Re, Hh, Hh, Hh, Hh, Hh, Hh, Hh, Hh, Hh, Gs^Vl, Hh, Hh, Hh, Hh, Hh, Hh, Hh, Hh, Gd, Gd, Hd, Hd, Hd, Hd, Hd
Gg, Gg, Hh, Hh, Re, Re, Hhd, Hh, Hhd, Hh, Hh, Hh, Hh, Hh, Hh^Fp, Hh^Fp, Hh^Fp, Hh^Fp, Hh^Fp, Hh, Hh, Hh, Hhd, Hhd, Hhd, Hhd, Hhd, Gd, Gd^Vh, Hd, Hd, Hd
Hh, Hh, Hh, Hh, Re, Re, Hhd, Hhd, Mm, Hhd, Hhd, Hh^Fp, Hh^Fp, Hh^Fp, Hh^Fp, Hh^Fp, Hh^Fp, Hh^Fp, Hh, Hh, Hh, Hhd, Hd, Md, Md, Md, Md, Md, Md, Md, Md, Hd
Mm, Mm, Hh^Fp, Hh^Fp, Re, Re, Hhd, Mm, Hhd, Hh^Fp, Hh^Fp, Hh^Fp, Hh^Fp, Hh^Fp, Hh^Fp, Hh^Fp, Hh^Fp, Hh^Fp, Hh^Fp, Hh, Hhd, Hhd, Md, Hd, Hd, Md, Md, Md, Hd, Hd, Md, Md
Hh, Hh^Vhhr, Hh, Hh^Fp, Ce, Re, Ce, Hhd, Hhd, Hhd, Hh^Fp, Hh^Fp, Hh^Fp, Hh^Fp, Hh^Fp, Hh^Fp, Hh^Fp, Hh^Fp, Hh^Fp, Hh^Fp, Hh^Fp, Hh^Fp, Md, Md, Md, Hd, Hd, Hd, Md, Md, Ms, Md
Hhd, Hh, Hh, Ce, 1 Ke, Ce, 2 Ke, Ce, Hhd, Hhd, Hhd, Hh^Fp, Hhd, Hhd, Hh^Fp, Hh^Fp, Hh^Fp, Hh^Fp, Hh^Fp, Hh^Fp, Md, Md, Ms, Ms, Ms, Md, Hd, Md, Ms, Ms, Ms, Ms
Hhd, Hhd, Hh, Ce, Ce, Ce, Ce, Ce, Hhd, Hhd, Hhd, Hhd, Mm, Mm, Mm, Mm, Gll^Ve, Hh^Fp, Hh^Fp, Hh^Fp, Md, Ms, Ms, Ms, Ms, Md, Hd, Md, Md, Ms, Ms, Ms
Md, Md, Hh, Hh, Hhd, Hh, Re, Re, Mm, Mm, Mm, Hhd, Mm, Mm, Mm, Hhd, Hhd, Hhd, Hhd, Md, Md, Ms, Ms, Ms, Ms, Md, Hd, Md, Md, Ms, Md, Ms
Md, Md, Hhd, Hhd, Hhd, Hhd, Re, Re, Mm, Ms, Mm, Hhd, Hhd, Hhd, Hhd, Hhd, Hhd, Hhd, Hhd, Md, Md, Md, Md, Ms, Md, Md, Md, Hd, Hd, Md, Ms, Md
Xue, Xue, Xue, Xue, Re, Re, Re, Hhd^Vhh, Mm, Mm, Ms, Md, Md, Md, Md, Md, Md, Md, Md, Md, Md, Md, Ms^Vhha, Md, Md, Md, Md, Md, Hd, Ms^Vhha, Ms, Ms
Uu, Uu, Uu, Uu, Xue, Re, Re, Hhd, Md, Md, Md, Md, Md, Md, Hh^Fp, Md, Hh^Fp, Md, Md, Md, Md, Ms, Ms, Ms, Ms, Ms, Ms, Md, Hd, Ms, Ms, Ms
Xue, Xue, Xue, Xue, Xue, Re, Re, Md, Md, Md, Md, Md, Gg, Hh^Fp, Hh^Fp, Hh^Fp, Hh^Fp, Md, Md, Md, Md, Ms, Ms, Ms, Ms, Ms, Ms, Md, Md, Hd, Ms, Ms
