Uh^Vud, Xu, Rb^Es, Xu, Xu, Xu, Rb^Es, Uh^Vud, Uh, Xu, Xu, Xu, Xu, Ai, Ai, Xu, Xu, Xu
Xu, Uu, Xu, Rb^Es, Uu, Ur^Es, Xu, Rb^Es, Ur^Es, Xu, Xu, Xu, Xu, Xu, Xu, Ai^Es, 1 Ur, Uu
Xu, Rb^Es, Xu, Xu, Xu, Xu, Xu, Xu, Uu^Es, Xu, Uu, Cud^WebS, Cud, Xu, Uu, Ww, Ww^Es, Xu
Rb^Es, Ur^Es, Uh, Xu, Xu, Uu^WebS, Urb, Uu^Vud, Uu, Ur, Ur, Uu, Uu, Cud, Cud, 2 Ur, Ai^Es, Xu
Ur^Es, Xu, Xu, Xu, Urb, Urb, Urb, Urb, Cud, Uu^Dr, Uu^Dr, Uu, Ur, Ur, Cud^Dr, Xu, Xu, Ai^Es
Xu, Xu, Xu, Urb, Urb^Es, Urb, Urb, Cud^Es, Cud, Cud, Cud, Uu, Uu^Es, Uu, Uu^Vud, Xu, Xu, Ai^Es
Uh, Xu, Xu, Cud^Es, Cud^Es, Urb, Urb, Urb^Es, Urb^Es, Cud, Cud, Cud^Dr, Urb, Uu^Es, Uu^Dr, Xu, Xu, Xu
Xu, Xu, Cud^Es, Kud, Cud^Es, Urb^Es, Urb^Es, Urb^Es, Urb^Es, Urb, Urb, Urb, Urb, Urb, Uu^WebS, Xu, Xu, Xu
Xu, Cud, Urb^Es, Cud^Es, Urb^Es, Cud^Dr, Cud, Urb, Cud, Urb, Urb, Urb, Urb^Dr, Uu^Es, Xu, Xu, Xu, Xu
