Xue, Xue, Xue, Xue, Xue, Xue, Xue, Xue, Xue, Xue, Xue, Xu, Xu, Xu, Xu, Xu, Xu, Xu, Xu, Xu, Xu, Ai, Xu, Xu, Xu, Xu, Xu, Xu, Xu, Xu, Xu, Xu, Xu, Xu, Xu, Xu, Xu, Xu, Xu, Xu, Xu, Xu, Xu, Xu, Xu, Xu, Ai^Es, Xu, Xu, Xu, Xu, Xu, Xu, Xu, Xu
Xue, Xue, Xue, Xue, Xue, Xue, Xue, Xue, Xue, Xue, Xue, Xue, Xue, Xu, Xu, Xu, Xu, Xu, Xu, Xu, Xu, Ai, Xu, Xu, Uh^WebS, Xu, Xu, Xu, Uh^Vu, Xu, Xu, Xu, Xu, Xu, Xu, Xu, Xu, Xu, Xu, Xu, Xu, Xu, Xu, Xu, Xu, Xu, Xu, Ai^Es, Ai, Xu, Xu, Xu, Xu, Xu, Xu
Xue, Xue, Xue, Xue, Xue, Xue, Xue, Xue, Xue, Xue, Xue, Xue, Xue, Xu, Xu, Xu, Xu, Xu, Xu, Xu, Xu, Ai, Uu, Uue^Tf, Rb^Es, Uu^Em, Uh, Uu^Es, Uu^Es, Xu, Xu, Xu, Xu, Xu, Xu, Xu, Uh^Vud, Xu, Rb^Es, Xu, Xu, Xu, Rb^Es, Uh^Vud, Uh, Xu, Xu, Xu, Xu, Ai, Ai, Xu, Xu, Xu, Uu
Xue, Xue, Xue, Xue, Xue, Xue, Xue, Xue, Xue, Xue, Xue, Xue, Xue, Xu, Xu, Xu, Xu, Xu, Uh^Es, Xu, Ai^Es, Ai, Xu, Uu^Es, Uu^Es, Ur^Es, Ur^Es, Uue^Tf, Xu, Xu, Uh, Xu, Uh^WebS, Xu, Xu, Xu, Xu, Uu, Xu, Rb^Es, Uu, Ur^Es, Xu, Rb^Es, Ur^Es, Xu, Xu, Xu, Xu, Xu, Xu, Ai^Es, Ur, Uu, Xu
Xue, Xue, Xue, Xue, Xue, Xue, Xue, Uue^WebS, Rb^Es, Rb^Es, Uue^Vu, Xue, Xue, Xue, Xu, Uh^WebS, Uu^Vud, Uh^Es, Ww^Es, Ww^Es, Xu, Xu, Uh^WebS, Uh^Vu, Uh, Xu, Ur^Es, Uu^Es, Uu^Em, Uh, Xu, Uh, Rb^Es, Xu, Xu, Xu, Xu, Rb^Es, Xu, Xu, Xu, Xu, Xu, Xu, Uu^Es, Xu, Uu, Cud^WebS, Cud, Xu, Uu, Ww, Ww^Es, Xu, Xu
Xue, Xue, Xue, Xue, Xue, Xue, Xue, Uue, Xue, Xue, Xue, Uue^Dr, Uue^Tf, Xue, Xue, Uh, Uu, Uh^Es, Ww, Uu^Es, Xu, Xu, Xu, Uh, Uh, Xu, Uu^Vud, Ur^Em, Qxu^WebS, Uh^Tf, Uh, Rb^Es, Uh^Tf, Xu, Xu, Xu, Rb^Es, Ur^Es, Uh, Xu, Xu, Uu^WebS, Urb, Uu^Vud, Uu, Ur, Ur, Uu, Uu, Cud, Cud, Ur, Ai^Es, Xu, Xu
Xue, Xue, Xue, Xue, Xue, Xue, Xue, Rb^Es, Xue, Xue, Xue, Xue, Uue^Tf, Xue, Rb^WebS, Xue, Xu, Uu, Ai^Es, Xu, Uu^Es, Uh^WebS, Uh, Xu, Uh, Uu, Uh, Uh^Em, Ur^Em, Qxu^WebS, Uh, Rb^Es, Xu, Uh, Xu, Xu, Ur^Em, Xu, Xu, Xu, Urb, Urb, Urb, Urb, Cud, Uu, Uu, Uu, Ur, Ur, Cud^Dr, Xu, Xu, Ai^Es, Xu
Xue, Xue, Xue, Xue, Uue^Vu, Uue^WebS, Uue^Tf, Uue^Tf, Uue, Xue, Xue, Uue^Dr, Uue, Uue, Uue^Tf, Xue, Xue, Xu, Uh, Ww^Es, Ur^Es, Uu^Es, Cud, Kud, Ur^Es, Ur, Rb^Es, Uh^Em, Uh, Rb^Es, Rb^Em, Uu^Em, Ur^Em, Ur^Es, Uu^Vud, Uu, Xu, Xu, Xu, Urb, Urb^Es, Urb, Urb, Cud^Es, Cud, Cud^Qov, Cud, Uu, Uu^Es, Uu, Uu^Vud, Xu, Xu, Ai, Ai
Xu, Xue, Xue, Xue, Rb^Es, Uue, Rb^Es, Uue, Rb^Es, Rb^Es, Uue, Xue, Uue^Tf, Rb^Es, Uue^Dr, Uue^Tf, Uue^Dr, Rb^Es, Uue, Ww, Ww^Es, Uh, Cud^Es, Uu, Uu, Xu, Xu, Xu, Uh, Rb^Es, Uh, Uh, Xu, Uu^Em, Uu^Em, Ur^Es, Uh, Xu, Xu, Cud^Es, Cud^Es, Urb, Urb, Urb^Es, Urb^Es, Cud, Cud, Cud^Dr, Urb, Uu^Es, Uu^Dr, Xu, Xu, Xu, Ai
Uu, Xu, Rb^Es, Uue, Xu, Uue^Dr, Uh^Es, Rb^Es, Rb^Es, Uue, Uue, Rb^Es, Uue, Uue^Tf, Uue, Uue, Qxe, Rb^Es, Uue^Dr, Rb^Es, Ai^Es, Xu, Xu, Ur^Es, Uh, Xu, Xu, Uh, Ur^Em, Uh^Tf, Uh, Xu, Rb^Es, Ur^Es, Xu, Xu, Xu, Xu, Cud^Es, 1 Kud, Cud^Es, Urb^Es, Urb^Es, Urb^Es, Urb^Es, Urb, Urb, Urb, Urb, Urb, Uu^WebS, Xu, Xu, Xu, Xu
Xu, Ur^Es, Xue, Xu, Xue, Xu, Xue, Uh^Es, Uh^Es, Rb^Es, Uh^Es, Uue, Xue, Xue, Uue^Tf, Uue^Tf, Uue^Dr, Uue^Tf, Uue^WebS, Xue, Xue, Ww^Es, Xu, Uh^WebS, Uh, Uh, Rb^Es, Rb^Es, Uu^Dr, Uh, Uu, Ur^Es, Uu^WebS, Ur^WebS, Xu, Xu, Xu, Cud, Urb^Es, Cud^Es, Urb^Es, Cud^Dr, Cud, Urb, Cud, Urb, Urb, Urb, Urb^Dr, Uu^Es, Xu, Xu, Xu, Xu, Xu
Xue, Xue, Xue, Xue, Uue^Vu, Xue, Uue^WebS, Xue, Xue, Uh^WebS, Xu, Uh^Es, Rb^Es, Xue, Uue^Tf, Uue^Dr, Uue, Uue^Tf, Xue, Xue, Ai^Es, Ai^Es, Xu, Xu, Xu, Uu^Dr, Rb^Es, Uu^Dr, Rb^Es, Xu, Xu, Xu, Xu, Xu, Uh^WebS, Xu, Cud^Dr, Cud, Urb, Urb^Es, Urb, Urb^Es, Urb, Cud, 2 Kud, Cud, Urb^Es, Urb^Es, Uu^Es, Uu^Es, Uu^WebS, Xu, Xu, Xu, Xu
Xue, Xue, Xue, Xue, Uue^Dr, Uue, Rb^Es, Xue, Rb^Es, Xue, Uue, Uh^Es, Xu, Uue^Vu, Xue, Uue^WebS, Xue, Xue, Xue, Ai, Xu, Xu, Xu, Xu, Xu, Xu, Xu, Uh, Uu, Xu, Uu^Vu, Uh, Uh^Es, Uh, Ur^Es, Uu^Es, Ur, Ur, Ur^Es, Urb, Urb, Urb^Es, Cud^Dr, Cud, Cud, Cud, Cud^Dr, Uu^Es, Uu^Vud, Uu, Xu, Xu, Uh^WebS, Xu, Xu
Xue, Xue, Xue, Rb^Es, Rb^Es, Qxe, Uue, Rb^Es, Uue^WebS, Uue, Xue, Xue, Xue, Xue, Xue, Xue, Ai, Xue, Ai, Ai^Es, Xu, Xu, Xu, Xu, Xu, Xu, Xu, Uu^Dr, Ur^Es, Ur^Es, Ur^Es, Uu, Ur^Es, Ur, Uu^Es, Uu^Es, Uh, Uu, Uh, Ur^Es, Cud^Es, Cud^Dr, Xu, Xu, Xu, Xu, Xu, Xu, Ur, Ur, Xu, Uh, Uu^Vud, Xu, Xu
Xue, Xue, Xue, Uue^Dr, Uue^Dr, Qxe, Uue^Vu, Xue, Xue, Xue, Xue, Xue, Ai, Ai, Ai^Es, Ai^Es, Xu, Ai^Es, Xu, Xu, Xu, Xu, Xu, Xu, Xu, Xu, Xu, Xu, Uh^WebS, Uu, Ur^Es, Uu, Uh, Uu^Es, Uh, Uh, Uu, Uh^Es, Xu, Cud^Es, Xu, Xu, Xu, Xu, Uh^Vud, Ur^WebS, Ur, Uu, Xu, Uu, Uu, Ur, Uu^WebS, Uu^WebS, Xu
Xue, Xue, Xue, Xue, Xue, Uue^WebS, Xue, Xue, Xue, Xue, Ai, Ai, Xue, Xu, Xu, Xu, Xu, Xu, Xu, Xu, Xu, Xu, Xu, Xu, Xu, Xu, Xu, Xu, Xu, Uu, Xu, Uu, Xu, Uh, Xu, Uh^WebS, Xu, Xu, Xu, Xu, Xu, Xu, Xu, Xu, Xu, Uh, Xu, Xu, Xu, Xu, Xu, Xu, Xu, Xu, Xu
Xue, Xu, Xue, Xu, Xue, Xu, Xu, Xue, Ai, Ai, Xue, Xu, Xue, Xu, Xu, Xu, Xu, Xu, Xu, Xu, Xu, Xu, Xu, Xu, Xu, Xu, Xu, Xu, Xu, Xu, Xu, Xu, Xu, Xu, Xu, Xu, Xu, Xu, Xu, Xu, Xu, Xu, Xu, Xu, Xu, Xu, Xu, Xu, Xu, Xu, Xu, Xu, Xu, Xu, Xu
