Xu, Xu, Xu, Xu, Xu, Xu, Xu, Xu, Xu, Xu, Xu, Xu, Xu, Xu, Xu, Xu, Xu, Xu, Xu, Xu, Xu, Xu, Xu, Xu, Xu, Xu, Xu, Xu, Xu, Xu, Xu, Xu, Xu, Xu, Xu, Xu, Xu, Xu, Xu, Xu
Xu, Xu, Xu, Xu, Xu, Xu, Xu, Xu, Xu, Xu, Xu, Xu, Xu, Xu, Xu, Xu, Xu, Xu, Xu, Xu, Xu, Xu, Xu, Xu, Xu, Xu, Xu, Xu, Ur, Ur, Ur, Uu, Uu, Uu, Uu, Xu, Ur, Ur, Ur, Ur
Qlf, Xu, Xu, Xu, Xu, Xu, Xu, Xu, Xu, Xu, Xu, Xu, Xu, Xu, Xu, Xu, Ql, Ql, Ql, Xu, Xu, Xu, Xu, Xu, Xu, Xu, Uu^Vud, Uu, Xu, Xu, Xu, Ur, Ur, Uu, Ur, Ur, Xu, Xu, Xu, Xu
Qlf, Qlf, Qlf, Qlf, Xu, Xu, Xu, Xu, Xu, Xu, Xu, Xu, Xu, Xu, Xu, Xu, Ql, Ql, Ql, Xu, Xu, Xu, Xu, Xu, Xu, Uu, Uu, Uu, Xu, Xu, Cud, Cud, 1 Kud, Ur, Uu, Uu, Xu, Xu, Xu, Xu
Xu, Qlf, Qlf, Qlf, Qlf, Xu, Xu, Xu, Ql, Ql, Ql, Ql, Ql, Ql, Ql, Ql, Ql, Ql, Ql, Uh, Ur, Uu^Vud, Uu^Vud, Xu, Xu, Xu, Xu, Xu, Uh, Xu, Uu, Cud, Cud, 2 Kud, Cud, Uu, Xu, Xu, Xu, Xu
Xu, Qlf, Xu, Qlf, Qlf, Qlf, Qlf, Ql, Ql, Ql, Ql, Ql, Ql, Ql, Ql, Ql, Xu, Ql, Ql^Bs/, Ur, Ql, Ql, Ql, Xu, Xu, Xu, Xu, Xu, Uh, Uu, Ur, Ur, Uu, Cud, Cud, Ur, Ur, Xu, Xu, Xu
Xu, Xu, Xu, Xu, Qlf, Qlf, Ql, Ql, Ql, Ql, Ql, Ql, Ql, Ql, Ql, Ql, Ur, Ur, Ql, Ql, Ql, Ql, Ql, Ql, Ql, Uh, Uh, Uh, Uh, Ur, Uh, Uu, Ql, Xu, Xu, Xu, Xu, Ur, Xu, Xu
Xu, Xu, Xu, Xu, Qlf, Qlf, Ql, Ql, Uh, Xu, Xu, Xu, Xu, Xu, Uu, Ql^Bs/, Ql, Uu, Uu, Ql, Ql, Ql, Ql, Ql, Ql, Uu, Ur, Ur, Ur, Ur, Uh, Ql, Ql, Ql, Xu, Xu, Uu, Uu, Xu, Xu
Xu, Xu, Xu, Qlf, Qlf, Qlf, Xu, Xu, Xu, Uh, Uh, Uh^Vu, Uh, Uh, Ur, Ql, Ql, Ql, Ql, Uu, Ur, Uu, Ur, Ql, Ql^Bs/, Ur, Ql, Uu, Ur, Uh, Uh, Xu, Xu, Xu, Xu, Xu, Uu, Uu^Vu, Xu, Xu
Xu, Xu, Xu, Qlf, Cud, Cud, Cud, Uu, Uu, Uh, Ur, Ur, Uu, Uu, Uu, Ql, Ql, Ql, Ql, Ur, Uh, Uh, Uh, Ur, Ql, Ql, Ql, Ql, Ur, Uu, Uh, Ql, Ql, Xu, Uu^Vud, Xu, Xu, Uu, Xu, Xu
Xu, Xu, Xu, Cud, Uu, 5 Kud, Uu, Uu, Uh, Ur, Uh, Uu, Ur, Ur, Uh, Uu, Ql^Bs\, Ql, Ql, Uh, Uh, Uh, Uh, Uu^Vud, Ql, Ql, Ql, Ql, Ur, Uu, Ql, Ql, Ql, Ql, Ql, Ur, Ur, Xu, Xu, Xu
Xu, Xu, Xu, Cud, Uu, Ur, Uu, Uh, Xu, Xu, Uh, Uh, Uh, Uu, Ur, Ql, Ql, Uu, Uu, Uu, Uh, Xu, Xu, Uh, Uu, Ql, Ql^Bs/, Uu, Uh, Xu, Ql, Ql, Ql, Ql, Ql, Ql, Xu, Xu, Xu, Xu
Xu, Xu, Xu, Uu, Ur, Ur, Uu, Uh, Uh^Vu, Xu, Uh, Uh, Xu, Uh, Ql^Bs\, Ql, Ql, Ql, Uu, Uh, Uh, Xu, Uh, Uh, Uh, Uh, Ql, Uu, Ur, Uu, Ql^Bs\, Ql, Ql, Ql, Ql, Ql, Ql, Xu, Ql, Xu
Xu, Xu, Xu, Xu, Uh, Uu, Uu, Ur, Uu, Uh, Ur, Xu, Xu, Ql, Ql, Ql^Bs\, Ql^Bs\, Ql, Uu, Uu, Uu, Uh, Uh, Uh, Ur, Ur, Ql, Ql, Ql, Ql, Ql, Ql^Bs\, Uu, Uh, Xu, Ql, Ql, Ql, Ql, Ql
Xu, Xu, Xu, Xu, Xu, Uh, Uh, Ur, Uu, Uh, Xu, Xu, Xu, Ql, Ql, Ql, Xu, Uu, Ql, Ql, Uu, Ql, Ql, Ql, Ql, Ql, Ql, Ql, Ql, Ql, Ur, Uu, Uu, Uh, Uu^Vud, Xu, Xu, Ql, Ql, Ql
Xu, Xu, Xu, Xu, Xu, Xu, Xu, Uh, Uh, Uh, Uh, Xu, Uh, Ql, Ql, Ql, Xu, Ql, Ql, Ql, Ql, Ql, Ql, Ql, Ql, Ql, Ql, Ql, Uu, Uu, Uu, Ur, Uu, Ur, Uh, Xu, Xu, Xu, Xu, Ql
Xu, Xu, Xu, Xu, Xu, Xu, Xu, Xu, Ur, Ur, Uu, Uh, Xu, Xu, Xu, Xu, Xu, Xu, Xu, Ql, Ql, Ql, Ql, Ql, Ql, Ql, Uh, Uh, Uh, Uu, Uu, Ur, Uu, Uh, Uh, Uh, Xu, Xu, Xu, Xu
Xu, Xu, Xu, Xu, Xu, Xu, Xu, Xu, Xu, Uu, Ur, Ur, Ur, Xu, Xu, Xu, Xu, Xu, Xu, Xu, Xu, Xu, Xu, Xu, Xu, Xu, Uh, Uh, Uh, Uh, Uh, Uu, Ur, Uh, Uh, Xu, Xu, Xu, Xu, Xu
Xu, Xu, Xu, Xu, Xu, Xu, Xu, Xu, Xu, Uu, Uu, Ur, Uu, Uu, Uh, Xu, Uh, Xu, Uh, Xu, Uh, Xu, Xu, Xu, Xu, Xu, Xu, Uh, Xu, Uh, Uh, Ur, Uh, Uh, Uh^Tf, Uh, Xu, Xu, Xu, Xu
Xu, Xu, Xu, Xu, Xu, Xu, Xu, Xu, Uh, Uh, Uh, Ur, Ur, Uu, Uh, Uh, Uu, Uh, Uu, Uh, Uu, Uh, Xu, Xu, Xu, Xu, Xu, Xu, Xu, Uh, Xu, Uh^Vu, Xu, Uh^Tf, Uh^Tf, Xu, Xu, Xu, Xu, Xu
Xu, Xu, Xu, Xu, Xu, Xu, Xu, Uh, Uh^Vu, Uh, Uu, Ur, Uu, Uu, Uu, Uu, Ur, Ur, Uu, Uu, Uu, Uu, Uu, Uu, Uu, Xu, Xu, Xu, Xu, Xu, Xu, Xu, Xu, Uh^Tf, Wwg, Xu, Xu, Xu, Xu, Xu
Xu, Xu, Xu, Qxu, Qxu, Xu, Xu, Uh, Uh, Uh, Uu, Ur, Uu, Ur, Qxu, Ur, Qxu, Qxu, Qxu, Qxu, Qxu, Uu, Uh, Uu, Uu, Uu, Uu, Xu, Xu, Xu, Xu, Xu, Wwg, Wwg, Wog, Wwg, Uh^Tf, Xu, Xu, Xu
Xu, Xu, Xu, Xu, Xu, Qxu, Qxu, Uh, Uh, Uh, Uu, Uu, Qxu^Bs\, Qxu^Bs\, Ur, Qxu, Qxu, Qxu, Qxu, Qxu, Qxu, Qxu, Qxu, Uh, Uh, Uu, Uu, Uu, Xu, Xu, Xu, Wwg, Wog, Wog, Wog, Wwg, Wwg, Xu, Xu, Xu
Xu, Xu, Xu, Xu, Xu, Xu, Xu, Qxu, Qxu, Uh, Uu, Qxu, Qxu, Uu, Ur, Qxu, Ur, Qxu, Qxu, Qxu, Qxu, Qxu, Qxu, Qxu, Qxu, Uh^Vu, Uu, Uu, Uu, Xu, Uh^Tf, Wwg, Wwg, Wog, Wwg, Wog, Wwg, Xu, Xu, Xu
Xu, Xu, Xu, Xu, Xu, Xu, Xu, Uh, Uu, Qxu, Qxu, Qxu, Uu, Uu, Uu^Vu, Uu, Uu, Ur, Qxu, Qxu, Qxu, Qxu, Uh, Qxu, Qxu, Qxu, Uu, Uu, Uu, Uh, Uh^Tf, Uh^Tf, Uh^Tf, Wwg, Uh^Tf, Wwg, Uh^Tf, Xu, Xu, Xu
Xu, Xu, Xu, Xu, Xu, Xu, Uu, Uu, Qxu, Qxu, Uh, Uu, Ur, Uu, Ur, Uu, Uu, Uu, Uu, Qxu, Ur, Uh, Uu, Uu, Uu, Qxu, Uu, Uu, Uh, Uh, Uu, Uu, Uh^Tf, Uh^Tf, Uh^Tf, Uh^Tf, Xu, Xu, Xu, Xu
Xu, Xu, Xu, Xu, Uh, Uu, Qxu, Qxu, Uh, Uh, Uh, Uh, Uu, Uu, Ur, Uu, Uu, Uu, Uu, Uu, Uu, Uu, Uu, Uu, Uu, Uh, Uh, Uh, Uh, Uh, Qxu, Uu^Tf, Uh, Uu^Vu, Uh^Tf, Uh, Uh, Xu, Xu, Xu
Xu, Xu, Uh, Uh, Ur, Qxu, Uh, Uu, Uh, Uh, Xu, Xu, Xu, Uu, Uu, Uu, Uu, Uu, Uu, Cud, Cud, Cud, Uu, Uu, Uu, Uu, Uh, Uh, Uh, Uu, Ur, Qxu, Qxu, Uu, Qxu, Uh, Uh, Xu, Xu, Xu
Xu, Xu, Uu, Uh, Uh, Ur, Uu, Uu, Xu, Xu, Xu, Xu, Xu, Uu, Uu, Uu, Xu, Uu, Uu, Cud, Cud, Cud, Xu, Xu, Xu, Uh, Uu, Uh, Uh, Uu, Ur, Qxu, Qxu, Qxu, Qxu, Qxu, Xu, Xu, Xu, Xu
Xu, Xu, Uh, Uh, Uu^Vu, Uh, Uu, Xu, Xu, Xu, Xu, Xu, Uu, Uu, Ur, Uu, Xu, Uu, Uu, Cud, 6 Kud, Cud, Xu, Xu, Xu, Uu, Uu, Uu, Uh, Uu, Uu, Ur, Uu, Qxu, Xu, Xu, Xu, Xu, Xu, Xu
Xu, Xu, Xu, Uh, Xu, Uu, Xu, Xu, Uu, Xu, Ur, Uu, Ur, Ur, Uu, Uu, Xu, Xu, Xu, Xu, Xu, Xu, Xu, Xu, Xu, Xu, Uu, Uu, Uu, Uu, Xu, Uu, Xu, Xu, Xu, Xu, Xu, Xu, Xu, Xu
Xu, Xu, Xu, Xu, Xu, Xu, Uu, Uu, Uu, Uu, Ur, Ur, Uu, Uu, Uu, Uu, Xu, Xu, Xu, Xu, Xu, Xu, Xu, Xu, Ur, Xu, Uu, Uu, Uu, Uu, Xu, Xu, Xu, Xu, Xu, Xu, Xu, Xu, Xu, Xu
Xu, Xu, Xu, Xu, Xu, Xu, Uu, Uu, Ur, Uu, Wwg, Wwg, Wwg, Uu, Xu, Xu, Xu, Xu, Xu, Xu, Xu, Xu, Xu, Uu, Uu, Ur, Uu, Uu, Uu, Xu, Xu, Xu, Xu, Xu, Qxu, Xu, Xu, Xu, Qxu, Qxu
Xu, Xu, Xu, Xu, Xu, Xu, Uu, Uu, Ur, Wwg, Uu, Ur, Uu, Wwg, Xu, Xu, Xu, Xu, Ur, Ur, Ur, Ur, Ur, Ur, Uu, Uu, Qxu, Uu, Ur, Ur, Uu, Uu, Qxu, Qxu, Xu, Qxu, Qxu, Qxu, Xu, Qxu
Xu, Xu, Xu, Xu, Xu, Xu, Uu, Uu, Wwg, Wwg, Uu, Uu^Vu, Uu, Wwg, Wwg, Wwg, Wwg, Uu, Wwg, Uu, Uu, Ur, Qxu, Qxu, Qxu, Qxu, Qxu, Uu, Ur, Uu, Qxu, Qxu^Bs\, Uu, Uu, Uu^Vu, Xu, Xu, Xu, Xu, Xu
Xu, Xu, Xu, Xu, Uu, Uu, Uu, Uu, Wwg, Wwg, Xu, Uu, Uu, Uu, Uu, Ur, Ur, Wwg, Wwg, Uu, Uu, Uu, Uu, Qxu, Qxu, Qxu, Uu, Qxu, Qxu, Qxu, Qxu, Qxu, Uu, Ur, Cud, Cud, Ql, Ql, Xu, Xu
Xu, Xu, Xu, Uu, Uu, Xu, Uu, Xu, Xu, Wwg, Xu, Xu, Xu, Xu, Xu, Uu, Uu, Uu, Uu, Wwg, Wwg, Xu, Xu, Uu, Uu, Uu, Uu, Uu, Uu, Uu, Uu, Uu, Uu, Ur, Cud, 7 Kud, Ql, Ql, Xu, Xu
Xu, Xu, Xu, Uu, Uu, Xu, Uu, Xu, Xu, Wwg, Xu, Xu, Xu, Xu, Xu, Xu, Xu, Xu, Xu, Xu, Xu, Wwg, Xu, Uu, Uu, Uu, Uu, Uu, Xu, Xu, Xu, Xu, Xu, Uu^Vu, Uu, Cud, Xu, Ql, Xu, Xu
Xu, Xu, Uu, Uu, Xu, Xu, Xu, Xu, Xu, Wwg, Xu, Xu, Xu, Xu, Xu, Xu, Xu, Xu, Xu, Xu, Xu, Wwg, Xu, Xu, Xu, Xu, Xu, Xu, Xu, Xu, Xu, Xu, Xu, Xu, Xu, Xu, Xu, Xu, Xu, Xu
Uu, Uu, Xu, Xu, Xu, Xu, Xu, Xu, Wwg, Wwg, Xu, Xu, Xu, Xu, Xu, Xu, Xu, Xu, Xu, Xu, Xu, Wwg, Wwg, Xu, Xu, Xu, Xu, Xu, Xu, Xu, Xu, Xu, Xu, Xu, Xu, Xu, Xu, Xu, Xu, Xu
