Xu, Xu, Xu, Xu, Xu, Xu, Xu, Xu, Xu, Xu, Xu, Xu, Xu, Xu, Xu, Xu, Xu, Xu, Xu, Xu, Xu, Xu, Xu, Xu, Xu, Xu, Xu, Xu, Xu, Xu, Xu, Xu, Xu, Xu, Xu, Xu, Xu, Xu, Xu, Xu, Xu, Xu
Xu, Xu, Xu, Xu, Xu, Xu, Xu, Xu, Xu, Xu, Xu, Xu, Uh^Vud, Xu, Xu, Xu, Xu, Xu, Uh^CruS, Xu, Xu, Xu, Xu, Xu, Xu, Xu, Xu, Xu, Xu, Xu, Xu, Xu, Xu, Xu, Xu, Xu, Xu, Xu, Xu, Xu, Xu, Xu
Xu, Xu, Xu, Xu, Uh^CruS, Xu, Uh^CruS, Uh^CruS, Uh^CruS, Xu, Uh^CruS, Uh^CruS, Ur, Uh, Ur^Br/, Uu^Br\, Uh^Br\, Uh^Dr, Uh^CruS, Uu, Uh^Vud, Uh^CruS, Uh^CruS, Xu, Xu, Xu, Uu, Xu, Xu, Xu, Ur^Xo, Xu, Xu, Ur^Kov, Xu, Xu, Ur^Xo, Xu, Xu, Xu, Xu, Xu
Xu, Xu, Xu, Uh^CruS, Uh^Vud, Xu, Uh^CruS, Uh^CruS, Uu, Uh^CruS, Uu, Uh^Dr, Uu^Br/, Ur^Br/, Xu, Xu, Uu, Uu^Br\, Ur^Br/, Ur^Br\, Ur^Br\, Uh^CruS, Uu, Xu, Uh^Dr, Uh^Br|, Uh^Dr, Xu, Uu, Xu, Xu, Ur^Xo, Ur^Kov, Ur^Kov, Ur^Kov, Ur^Xo, Xu, Xu, Xu, Xu, Xu, Xu
Xu, Xu, Xu, Uh^Dr, Uu, Uu, Xu, Xu, Ur, Uu, Xu, Xu, Uh^CruS, Xu, Uu^Vud, Xu, Xu, Ur, Uh^Br|, Xu, Xu, Uu^Br\, Uu^Br\, Uu, Uu^Br/, Ur^Br/, Uh^CruS, Ur, Uu, Xu, Ur^Xo, Xu, Ur^Kov, Ur^Qov, Ur^Kov, Xu, Ur^Xo, Xu, Xu, Xu, Xu, Xu
Xu, Xu, Uh^CruS, Uh^Br\, Uh^Br\, Uu, Xu, Uu, Uh^CruS, Uu, Uh^CruS, Uh^CruS, Uu, Uh, Ur^Br\, Uu, Uh^Br/, Uu^Br\, Uu^Br\, Xu, Xu, Uu, Ur, Uu^Br/, Uu^Br|, Ur^Vud, Xu, Xu, Uu, Xu, Xu, Ur^Xo, Ur^Kov, Ur^Kov, Ur^Kov, Ur^Xo, Xu, Xu, Xu, Xu, Xu, Xu
Xu, Xu, Xu, Uh^CruS, Uu, Uu^Br|, Xu, Uu, Uu^CruS, Ur, Ur^Br\, Uh^CruS, Ur^Br/, Uu^Br/, Uh^Dr, Uh^Br\, Uh^CruS, Uu, Uu^CruS, Ur^Br\, Ur, Ur, Uh^CruS, Xu, Uh^Br\, Uu, Xu, Uh, Xu, Xu, Ur^Xo, Xu, Ur^Kov, Ur^Qov, Ur^Kov, Xu, Ur^Xo, Xu, Xu, Xu, Xu, Xu
Xu, Xu, Uh^CruS, Uu, Uu, Uu^Br|, Xu, Xu, Uh^Br/, Uu^Br/, Xu, Uh^Br\, Uh, Uh^Br|, Uh^Dr, Uh^CruS, Uh^CruS, Uu^CruS, Uu, Uh^Br|, Ur^Vud, Uh^CruS, Xu, Xu, Uu, Uh^Br|, Xu, Uu, Uh, Xu, Xu, Ur^Xo, Ur^Kov, 2 Ur^Kov, Ur^Kov, Ur^Xo, Xu, Xu, Xu, Xu, Xu, Xu
Wo, Xu, Xu, Uh, Xu, Uh^Br\, Uu^Br|, Uu^Br/, Uu, Uh^Vud, Uh^CruS, Uh^CruS, Xu, Ur^Br|, Uu^Br\, Uh^CruS, Xu, Xu, Uh, Uu^Br|, Uu, Uu, Uu, Xu, Ur^Br/, Uu^Br/, Xu, Ur, Uu, Xu^PsgS, Ur^Kov, Xu, Ur^Kov, Ur^Qov, Ur^Kov, Xu, Ur^Xo, Xu, Xu, Xu, Xu, Xu
Wo, Xu, Xu, Uh^CruS, Uh^Vud, Uu, Uh^Br|, Ur, Xu, Uu, Uh^CruS, Uh^CruS, Uu, Uu, Uh^Dr, Ur^Br|, Uu, Xu, Xu, Ur^Br\, Uh^Br\, Uu, Uh^Br/, Ur^Br/, Ur^Br\, Xu, Uh^Vud, Xu, Ur, Uu^Xo, Xu^PsgS, Ur^Xo, Ur^Kov, 1 Ur^Kov, Ur^Kov, Ur^Xo, Xu, Xu, Xu, Xu, Xu, Xu
Wo, Xu, Xu, Xu, Xu, Uh^CruS, Uh^Br|, Uh, Uh^CruS, Ur, Uu, Ur, Uh^CruS, Ur, Uh^Br/, Ur^Br|, Ur, Uu^CruS, Xu, Xu, Uh^Br|, Uu^Br\, Xu, Ur, Uh^CruS, Uh^Br\, Uu^Br|, Xu, Xu, Ur, Uh^Dr, Xu, Urb, Ur^Kov, Urb, Xu, Xu, Xu, Xu, Xu, Xu, Xu
Xu, Wo, Wo, Xu, Uh^Br/, Uh^Br/, Xu, Uh, Uu, Ur, Uh, Xu, Xu, Uh^Dr, Xu, Uh^CruS, Uu, Ur, Uu^CruS, Xu, Uu^Br|, Uh^CruS, Uu, Uh, Uh^CruS, Uh, Uh^Br\, Xu, Xu, Ur, Uh^Br|, Xu, Urb, Urb, Urb, Xu, Xu, Xu, Xu, Xu, Xu, Xu
Xu, Xu, Uh, Wo^Br/, Wo, Xu, Xu, Uh^Vud, Uh, Uu, Uh^CruS, Uu, Xu, Xu, Uh, Uh^CruS, Uh^Vud, Uu, Xu, Xu, Uh^Br|, Uh^CruS, Uu^CruS, Xu, Uh^CruS, Uh^CruS, Xu, Uu^Br|, Xu, Uu, Uu^Br|, Xu, Xu, Urb, Xu, Xu, Xu, Xu, Xu, Xu, Xu, Xu
Xu, Xu, Uh^CruS, Uh^Br|, Xu, Wo, Wo, Xu, Sm^Tf, Uh, Uh, Uh^CruS, Uh^CruS, Uh^CruS, Uh^CruS, Uu, Uu, Ur, Xu, Xu, Uu^Br\, Uh^Vud, Uh^CruS, Uh, Uh, Uh^CruS, Xu, Uu^Br\, Uu, Uh^Dr, Uu^Br|, Xu, Xu, Urb, Xu, Xu, Xu, Xu, Xu, Xu, Xu, Xu
Xu, Xu, Xu, Uh^Br|, Uh, Xu, Wo^Ii, Xu, Ss^Ii, Sm^Emf, Sm^Tf, Rb^Em, Uu, Uu, Uh^CruS, Ur, Uh, Xu, Xu, Uh^CruS, Uh, Uh^Br\, Uh^Br\, Ur, Xu, Xu, Uh^Br/, Uh^Br|, Uu^Br\, Uu, Uh^Br/, Xu, Xu, Urb, Urb^Xo, Xu, Xu, Xu, Xu, Xu, Xu, Xu
Xu, Xu, Uh^CruS, Uh^Br|, Uh^Vud, Xu, Ww^Ii, Ss^Ii, Rb^Tf, Sm^Tf, Sm^Em, Rb^Tf, Uh, Rb^Tf, Uh, Uu, Ur, Xu, Xu, Xu, Xu, Xu, Xu, Uu^Br\, Uu^Br/, Ur^Br/, Uu^CruS, Uh^Vud, Uh, Uh^Br/, Xu, Xu, Urb, Urb^GtoS, Xu, Xu, Uh, Xu, Uh, Xu, Xu, Xu
Xu, Xu, Uh^Br/, Uh^Br|, Xu, Ww, Ww, Xu, Sm^Tf, Rb^Tf, Rb^Tf, Rb^Tf, Rb^Em, Uh, Xu, Uu, Ur, Uu, Uu, Xu, Xu, Xu, Xu, Uh^CruS, Uh^CruS, Uh^CruS, Uh^CruS, Uh, Uu, Uh^CruS, Xu, Xu, Urb, Urb, Xu, Uh^Vu, Xu, Uh, Xu, Xu, Xu, Xu
Xu, Xu, Uh^Br|, Xu, Ww, Ww, Xu, Xu, Sm^Tf, Sm^Emf, Sm^Tf, Rb^Tf, Uu, Ur, Xu, Xu, Xu, Ur, Ur, Xu, Xu, Xu, Xu, Uh^CruS, Xu, Uh, Xu, Uu, Xu, Xu, Urb, Urb, Xu, Xu, Xu, Xu, Xu, Uh^CruS, Uh, Xu, Xu, Xu
Xu, Xu, Xu, Uh^Br\, Ww^Br\, Xu, Xu, Xu, Xu, Sm^Tf, Sm^Tf, Sm^Tf, Uh^CruS, Ur, Ur, Xu, Xu, Ur, Urb^Vud, Urb, Urb, Xu, Urb^Vud, Xu, Xu, Xu, Xu, Xu, Xu, Xu, Urb, Xu, Xu, Xu, Wwt, Wwt, Wwt, Xu, Uh, Xu, Xu, Xu
Xu, Xu, Xu, Ww, Xu, Uh^Br\, Uh^Br|, Xu, Xu, Xu, Xu, Xu, Xu, Uu, Ur, Ur, Urb, Urb, Urb, Urb, Xos^Efs, Urb, Urb, Urb, Urb, Xu, Xu, Xu, Urb, Urb, Xu, Xu, Wwt, Wwt, Wot, Wot, Wot, Wwt, Wwt, Xu, Xu, Xu
Xu, Xu, Xu, Ww, Xu, Xu, Uh^Br\, Xu, Xu, Xu, Xu, Xu, Xu, Xu, Urb, Urb, Urb, Urb, Xos^Efs, Urb, Urb, Urb, Xos^Efs, Urb, Urb, Urb, Urb, Urb, Xu, Xu, Xu, Xu, Wwt, Wot, Wot, Wo^Ii, Wo^Ii, Wot, Wwt, Wwt, Xu, Xu
Xu, Xu, Ww, Ww, Xu, Xu, Uh^Br|, Xu, Xu, Xu, Xu, Xu, Urb, Urb, Urb, Urb, Urb, Urb, Urb, Urb, Xos^Efs, Urb, Urb, Urb, Urb, Urb, Urb, Urb, Urb, Xu, Xu, Xu, Xu, Wwt, Wwt, Wot, Wot, Wot, Wwt, Xu, Xu, Xu
Ww, Ww, Xu, Xu, Xu, Xu, Uu^Br/, Xu, Xu, Xu, Urb, Urb^Vud, Urb, Urb, Xos^Efs, Urb, Urb, Urb, Urb, Urb, Urb, Urb, Urb, Urb, Urb, Urb, Xos^Efs, Urb, Urb, Urb^Vud, Urb, Xu, Xu, Xu, Xu, Wwt^Bsb|, Wwt, Wwt, Xu, Xu, Xu, Xu
Xu, Xu, Xu, Xu, Uu^Br/, Uu^Br/, Xu, Xu, Urb, Urb, Urb, Urb, Xos^Efs, Urb, Urb, Urb, Xos^Efs, Urb, Urb, Urb, Urb^Vud, Urb, Urb, Urb, Xos^Efs, Urb, Urb, Urb, Xos^Efs, Urb, Urb, Urb, Urb, Xu, Xu, Ur, Ur, Xu, Ur, Ur, Xu, Xu
Xu, Xu, Uu^Br|, Uu^Br/, Xu, Xu, Urb, Urb, Urb, Urb, Urb, Urb, Urb, Urb, Xos^Efs, Urb, Urb, Urb, Urb, Urb, Urb, Urb, Urb, Urb, Urb, Urb, Xos^Efs, Urb, Urb, Urb, Urb, Urb, Urb, Urb, Urb, Ur, Xu, Ur, Ur, Ur, Xu, Xu
Xu, Xu, Uu^Br|, Xu, Urb^Vud, Urb, Urb, Urb, Xos^Efs, Urb, Urb, Urb, Urb, Urb, Urb, Urb, Urb, Urb, Urb, Cud, Xos^Efs, Cud, Urb, Urb, Urb, Urb, Urb, Urb, Urb, Urb, Urb, Urb, Xos^Efs, Urb, Urb, Urb, Urb^Vud, Xu, Uh, Xu, Xu, Xu
Xu, Xu, Uu^Br|, Xu, Urb, Urb, Xos^Efs, Urb, Urb, Urb, Xos^Efs, Urb, Urb, Urb, Urb^Vud, Urb, Urb, Cud, Xos^Cov, Cud, 5 Kud, Cud, Xos^Cov, Cud, Urb, Urb, Urb^Vud, Urb, Urb, Urb, Xos^Efs, Urb, Urb, Urb, Xos^Efs, Urb, Urb, Xu, Uh, Xu, Xu, Xu
Xu, Xu, Uu^Br|, Xu, Urb^Vud, Urb, Urb, Urb, Xos^Efs, Urb, Urb, Urb, Urb, Urb, Urb, Urb, Urb, Cud, Urb, Cud, Xos^Efs, Cud, Urb, Cud, Urb, Urb, Urb, Urb, Urb, Urb, Urb, Urb, Xos^Efs, Urb, Urb, Urb, Urb^Vud, Xu, Xu, Uh, Xu, Xu
Xu, Xu, Uu^Br|, Xu, Xu, Urb, Urb, Urb, Urb, Urb, Urb, Urb, Urb, Urb, Xos^Efs, Urb, Urb, Urb, Urb, Cud, Urb, Cud, Urb, Urb, Urb, Urb, Xos^Efs, Urb, Urb, Urb, Urb, Urb, Urb, Urb, Urb, Urb, Xu, Xu, Uh, Uh, Xu, Xu
Xu, Xu, Xu, Uu^Br\, Uu^Br\, Xu, Xu, Urb, Urb, Urb, Urb, Urb, Xos^Efs, Urb, Urb, Urb, Xos^Efs, Urb, Urb, Urb, Urb^Vud, Urb, Urb, Urb, Xos^Efs, Urb, Urb, Urb, Xos^Efs, Urb, Urb, Urb, Urb, Urb, Xu, Xu, Uu, Uu, Uh^CruS, Xu, Xu, Xu
Xu, Xu, Xu, Xu, Xu, Uu^Br\, Uu^Br\, Xu, Urb, Urb, Urb, Urb, Urb, Urb, Xos^Efs, Urb, Urb, Urb, Urb, Urb, Urb, Urb, Urb, Urb, Urb, Urb, Xos^Efs, Urb, Urb, Urb, Urb, Urb, Xu, Ur, Xu, Xu, Uh, Xu, Xu, Xu, Xu, Xu
Xu, Xu, Xu, Xu, Xu, Xu, Urb^Br|, Urb^Br\, Urb^Br\, Xu, Xu, Urb^Vud, Urb, Urb, Urb, Urb, Urb, Urb, Urb, Urb, Xos^Efs, Urb, Urb, Urb, Urb, Urb, Urb, Urb, Urb, Urb^Vud, Xu, Xu, Sm^Tf, Sm^Emf, Sm^Tf, Xu, Xu, Uh, Uu, Xu, Xu, Xu
Xu, Xu, Xu, Xu, Xu, Xu, Urb^Br\, Urb, Urb, Urb^Br\, Urb^Br|, Xu, Xu, Urb, Urb, Urb, Urb, Urb, Xos^Efs, Urb, Urb, Urb, Xos^Efs, Urb, Urb, Urb, Urb, Urb, Xu, Xu, Xu, Xu, Sm^Emf, Sm^Em, Rb^Tf, Sm^Emf, Xu, Xu, Uu, Uh, Xu, Xu
Xu, Xu, Xu, Xu, Urb, Urb, Urb, Urb^Br\, Urb^Br\, Urb, Urb^Br|, Urb, Xu, Xu, Xu, Urb, Urb, Urb, Urb, Urb, Xos^Efs, Urb, Urb, Urb, Urb, Urb, Rr, Xu, Xu, Xu, Xu, Sm^Tf, Sm^Tf, Sm^Tf, Rb^Tf, Sm^Tf, Xu, Xu, Uu, Xu, Xu, Xu
Xu, Xu, Xu, Xu, Xu, Urb, Urb, Urb, Urb, Urb^Br/, Xu, Xu, Urb, Urb, Urb, Xu, Urb^Pr\, Urb, Urb^Vud, Urb, Urb, Urb, Urb^Vud, Urb, Xu, Rr, Rr, Rr, Rr, Xu, Xu, Sm^Tf, Rb^Tf, Sm^Em, Sm^Emf, Rb^Tf, Uh, Xu, Uu, Uh, Xu, Xu
Xu, Xu, Xu, Xu, Xu, Xu, Xu, Urb, Xu, Xu, Xu, Xu, Xu, Urb, Urb, Urb, Urb, Xu, Xu, Xu, Xu, Xu, Xu, Xu, Xu, Xu, Xu, Rr, Rr, Xu, Xu, Xu, Rb^Tf, Rb^Tf, Rb^Tf, Xu, Uh, Uu, Uh, Xu, Xu, Xu
Xu, Xu, Xu, Xu, Xu, Xu, Xu, Xu, Xu, Xu, Xu, Xu, Xu, Xu, Xu, Urb, Urb, Urb, Xu, Xu, Xu, Xu, Xu, Xu, Xu, Xu, Xu, Rr, Rr, Xu, Xu, Xu, Xu, Xu, Xu, Xu, Xu, Xu, Xu, Xu, Xu, Xu
Xu, Xu, Xu, Xu, Xu, Xu, Xu, Xu, Xu, Xu, Xu, Xu, Xu, Xu, Xu, Xu, Xu, Xu, Xu, Xu, Xu, Xu, Xu, Xu, Xu, Xu, Xu, Rr, Rr, Xu, Xu, Xu, Xu, Xu, Xu, Xu, Xu, Xu, Xu, Xu, Xu, Xu
